вкусно – tasty
время – time
встать – to get up
встать с постели – to get out of bed
газета – a newspaper
готовить – to cook
готовить завтрак – to make breakfast
довольно – quite, rather
«дождить» – to rain
завтракать – to have breakfast
играть – to play
кино – cinema
кофе – coffee
мешать (беспокоить) – to bother; to disturb
муж – a husband
навести макияж – to make up, to beautify oneself
обедать – to have dinner
одеться – to get dressed, to dress
перекусить – to have a snack
переодеться – to change, to get changed
петь – to sing
пить – to drink
по будням – on week-days
помогать – to help
помыть посуду – to wash (to do) the dishes
постелить постель – to make the bed
приготовить завтрак – to make dinner
принимать ванну – to take (to have) a bath
принимать душ – to take (to have) a shower
приходить – to come
приходить вовремя – to come on time
причесаться – to do smb's hair
проголодаться – to get hungry
проснуться – to wake up
работа – work, a job
рано – early
ресторан – a restaurant
семья – a family
смотреть телевизор – to watch TV
спать – to sleep
темнеть – to get dark
теннис – tennis
убрать комнату – to tide up (to clean) the room
ужинать – to have supper
умываться – to wash
читать – to read
