артист –  an actor
в общем – generally speaking
военный – a military man
врач – a doctor
высококлассный специалист – a top-specialist
директор – a headmaster, a principal
журналист – a journalist, a pressman
заниматься чем-нибудь – to do something  
зато – but
и... и  – both...and
инженер – an engineer
к сожалению – unfortunately, I’m afraid
конечно – of course
к тому же – as well
литератор – a literary man
медсестра –a nurse
музыкант – a musician
няня – a nurse
парикмахер  женский – a hairdresser
парикмахер мужской – a barber 
певец – a singer
пенсионер – a pensioner
переводчик  устный – an interpreter
переводчик литературы – a translator 
полицейский – a policeman
портной – a dressmaker
программист – a programmer
продавец  в магазине – a salesman
продавец на улице – a vendor
режиссер – a director
спортсмен – a sportsman
студент – a student
ученик – a pupil
ученый – a scientist
учитель – a teacher
хотя – although; though (в разговорном английском обычно употребляется в конце предложения)
художник – an artist, a painter
шофер – a driver
экономист – an economist
юрист – a lawyer
