бегло – fluently
действительно – really, actually, truly, indeed, in fact
естественно – naturally  
особенно – especially; particularly
откровенно – frankly
постоянно – constantly
почти – almost
после – after
самый  – the very
точно! – true!
бабушка – a grandmother;  a grandma, 
a granny
брат – a brother
внук – a grandchild
внуки – grandchildren
внучка – a grandchild
двоюродная сестра – a cousin
двоюродный брат – a cousin
дедушка – a grand-dad; a grandpa(pa)
дети – children, kids; babies
дочь – a daughter
дядя – an uncle
жена – a wife
мама – ma, mum, mummy, mommy, mother
папа – dad
племянник – a nephew
племянница – a niece
правнук – a great-grandchild
правнуки – great-grandchildren
правнучка – a great-grandchild
родители – parents
родня – folks; kin
родственник – a relative, a relation; a kinsman
сестра – a sister; a sissy (амер., разг.)
сын – a son
тетя – an aunt (в соединении с именем пишется с прописной буквы)
безрассудный – thoughtless, unreasonable
благородный – noble, generous 
большой – 1) big; large (о неодушевленных предметах);
           большой промежуток – wide interval;
           большое число – great/large number; 
          2)(значительный, выдающийся) – great; 
          3)(важный) – important; 
          4) разг.(взрослый) – grown-up
большой палец – a thumb (на руке); a big toe (на ноге)
большой спорт – big-time sports
большая буква – capital letter 
великодушный – generous; noble
гениальный – genius (о человеке); great (о творении и т.п.)
дружелюбный – friendly
жадный – greedy
зависимый – dependent (on)
завистливый – envious
маленький – little, small
настоящий –  true, real
независимый – independent  
неуравновешенный – unbalanced
рабочий – working, work
рассудительный – wise; reasonable, sensible
ревнивый – jealous
самостоятельный – independent; self-dependent
талантливый – talented, gifted
тяжелый – (трудный, утомительный) hard, difficult
уравновешенный – steady, balanced, even-tempered
чуткий –1) keen, sharp, quick (о слухе и обонянии) – чуткий нюх; 2) перен. sensitive
щедрый – lavish, generous
эгоистичный – selfish
драться – to fight
мириться – 1)  помириться – to  make it up (with smb.),  
           2) примириться (терпимо относиться к чему-л.) to put up with, to bear with
обсуждать – to discuss; to talk over разг. 
ругаться – to abuse, to  scold 
сердиться – to  be(come) angry (with)
смеяться – 1)to  laugh;  
           2) (над кем-л./чем-л.) – to laugh (at), to make fun (of);  
           3) (шутить) to joke
ссориться – to quarrel (with)
улыбаться – to smile
улыбаться счастливой улыбкой – to smile a happy smile
улыбаться грустной улыбкой – to smile a sad smile
улыбаться сквозь слезы – to smile through one's tears
улыбнуться на прощание – to smile farewell
хихикать – to giggle
