бодрый – cheerful; bright
веселый – merry
взволнованный – excited
глупый – silly
голодный – hungry
горячий – hot
грустный – sad
довольный – pleased
жаркий – hot
занятой – busy
застенчивый – shy
злой – wicked
обеспокоенный – worried
печальный – sad
расстроенный – sad, upset (эмоционально); (о здоровье) impaired; (о музыкальном инструменте) out of tune
самоуверенный – self-confident, self-assured
сердитый – angry
скромный – modest
скучный (испытывающий скуку) – bored
скучный (наводящий скуку) – dull, boring
счастливый – happy
уверенный в себе – confident
умный – clever, smart
холодный – cold
погладить – to iron
подмести – to sweep
поехать на автобусе – to go by bus
   на машине – by car
   на метро – by underground, by subway
   на поезде – by train
   на такси – by a taxi
пойти на работу – to go to work
пойти пешком – to walk, to go on foot
постирать – to wash,to do some washing
пропылесосить – to vacuum
жарко – it is hot
холодно – it is cold
мне скучно – I am bored
когда – when
потом – then
потому что – because
поэтому – that’s why
просто – just 
просто шутка – just a joke
слишком – too
так как – as
это просто – it is easy
