вовсе не – not at all
и вообще – generally, in general,on the whole (в целом)
общаться – to mix with, to  communicate with
такой – such a
активный – active
великолепный – fine, splendid, excellent
выдающийся – outstanding
замечательный – great
замкнутый – reserved
красивый – beautiful
мерзкий – nasty, loathsome
милый – nice
общительный – sociable
обыкновенный – ordinary/average
отвратительный – nasty, loathsome
очаровательный – charming, fascinating
пассивный – passive
плохой – bad
прекрасный – wonderful
привлекательный – attractive, nice
противный – disgusting, nasty
симпатичный – nice
ужасный – terrible, horrible, awful
уродливый – ugly
хороший – good 
чудный – lovely
везунчик – a lucky fellow
домосед – a stay-at home
зануда – a bore
лентяй – an idler, a lazy person
лидер – a leader
личность – a personality
неудачник – a failure; a loser; an unlucky fellow/person
оптимист – an optimist
паникер – a panic-monger, a scare-monger
педант – a pedant
пессимист – a pessimist
подлиза – a lickspittle
работяга – a hard-worker
скряга – a niggard
сплетник – a news-monger
транжира – a spender
трус – a coward
тупица – a blockhead
умница – a clear head
фантазер – a dreamer
храбрец – a man of courage
