валять дурака – to play the fool
видеть выход из положения – to see daylight
выходить из себя (терять терпение) – to lose temper
встать не с той ноги – to get out of bed on the wrong side
гнуть спину – to break one's back


А вы? – What about you?
абсолютный нуль – an absolute nothing.
важная шишка – a big shot.
душа общества – the life and soul of the party.
Ему очень просто это сделать – It costs him nothing to do it
крепкий орешек – a hard nut to crack.
Кто вы по профессии? – What are you? What do you do?
Поверьте мне на слово – Take my word for it
хозяин своего слова – a man of his word.
честно говоря – honestly speaking, frankly speaking
Я мастер своего дела – I am an expert at my job


• быть способным к чему-нибудь – to be good at something.
• в самом деле? – indeed? really?
• в самый раз – just right
• на самом деле – indeed, actually, in (actual) fact
• не иметь способностей к чему-нибудь – to be bad at… 
• не улыбаясь – without a smile
• Он настоящий дурак. – He is an absolute fool.
• по натуре (по характеру) – in grain.
• по-моему – to my mind
• сказать по правде – to tell the truth
• Так и живем! – It’s our life!
• Так и живу! – It’s my life!
• Это действительно так. – This is so indeed, this is true.
• Это на меня  непохоже. – It is out of my way.
• Это на меня похоже, это в моем характере. – It is in my way.


• все-таки – nevertheless, (but) still, for all that, all the same, however
• кстати (между прочим) – by the way
• надеяться на лучшее – to hope for the Best
• настаивать на своем – to persist in somebody’s opinion
• ни за, ни против – neither for nor against 
• ни то, ни се – neither one thing nor the other 
• ни тот, ни другой – neither (the one nor the other)  
• преуспеть в жизни (сделать карьеру, выдвинуться) – to succeed in life
• стараться изо всех сил – to try to do somebody’s Best (я стараюсь изо всех сил – I try to do my Best)
• у меня такое ощущение – I've got a feeling
• Я это не выношу (терпеть этого не могу). – I can’t stand it
